UUUUUUUUUUUUUU
11111111111111
U222222222222U
U1U1U1U1U1U1UU
U222222222222U
UUUUUUBBBBUUUU

