BUBUBUBU
12121212
BUBUBUBU
21212121
BUBUBUBU
12121212
BUBUBUBU
21212121
