50000000000005
00000000000000
00BBBBBBBBBB00
00B55555555B00
00BBBBBBBBBB00
UUUUUUUUUUUUUU

