20000000000002
00000000000000
00BBBBBBBBBB00
00B22222222B00
00BBBBBBBBBB00
UUUUUUUUUUUUUU
