B111111B
15555551
15000551
15000551
15000551
15000551
15555551
B111111B
