BUBUBUBUBUBUBU
12121212121212
BUBUBUBUBUBUBU
21212121212121
BUBUBUBUBUBUBU
12121212121212

