B0B0B0B0
12121212
00000000
12121212
B0B0B0B0
12121212
00000000
12121212
