UUUUUUUUU
111111111
U2222222U
U1U1U1U1U
U2222222U
UUUUBUUUU
UUUU0UUUU
UUUU0UUUU

