0000000000
5000000000
0000000000
0000000000
0000000000
0000000000
0000000000
0000000000
0000000000
0UUUUUUUU0
