UUUUUUUUUUUUUU
11111111111111
U2U2U2U2U2U2U2
22222222222222
U1U1U1U1U1U1U1
11111111111111
UUUUUBBBUUUUUU
00000000000000
00000000000000
00000000000000
00000000000000
00000000000000
00000000000000
00000000000000

