B111111111111B
12222222222221
12000000000021
12000000000021
12222222222221
B111111111111B
