U U U U U
U121012101
U1U1U1U1U1
U212021202
U U U U U
U212021202
U1U1U1U1U1
U121012101
U U U U U
0000000000
