11111111111111
12222222222221
12UBUBUBUBUBU1
12UBUBUBUBUBU1
12222222222221
11111111111111

