11111111111111
22222222222222
22222222222222
111111BBBB1111
U2U2U2U2U2U2U2
11111111111111
11111111111111
11111111111111
5U5U5U5U5U5U5U
BBBBBBBBBBBBBB
22222222222222
00000000000000
00000000000000
00000000000000
