1111B111111
00000100000
00000100000
00000B00000
00000000000
00000000000
00000000000
00000000000
00000000000
00000000000
