U1U1U1U1U1U
12121212121
U1U1U1U1U1U
12121212121
U1U1U1U1U1U
12121212121
U1U1U1U1U1U
12121212121
U1U1U1U1U1U
00000000000
