B5B5B5B5B5B5B5
5B5B5B5B5B5B5B
U2U2U2U2U2U2U2
2U2U2U2U2U2U2U
U1U1U1U1U1U1U1
1U1U1U1U1U1U1U
B2B2B2B2B2B2B2
22222222222222
00000000000000
00000000000000
00000000000000
00000000000000
00000000000000
00000000000000

