B0B0B0B0B0B0B0
12121212121212
00000000000000
21212121212121
B0B0B0B0B0B0B0
12121212121212

