2222022222
2220002222
U U U U U
U U U U U
U U U U U
2222222222
1111111111
2222222222
UUUU11UUUU
UUUU11UUUU
