U121212121
UU000000UU
20U0000U02
100U00U001
2000220002
100U00U001
20U0000U02
2U000000U2
1121212121
0000000000
