000UUUUUUUU00
000U55B55U000
000U5BBB5U000
BBBU5B2B5UBBB
222U55255U222
111UUUUUUU111
BBBU55255UBBB
222U5BBB5U222
111U55B55U111
000UUUUUUU000
0000000000000
0000000000000
0000000000000


