U U U U U
U22222222U
U11222211U
U11122111U
U11112111U
U11111111U
UUUU0UUUUU
UUUU0UUUUU
UUUU0UUUUU
UUUU00UUUU
