UUUUUUUUUUUUUU
U555555555555U
UU5222222225UU
UUU52111125UUU
UUUU521125UUUU
UUUUU5225UUUUU
55555555555555
00000000000000
00000000000000
00000000000000
00000000000000
00000000000000
00000000000000
00000000000000
