U1002001UU
UU10201U1U
U1U121U10U
U01U1U100U
U0U010U0UU
U01U1U100U
U1U101U10U
UU10001U1U
U1000001UU
UUUU0UUUUU
