UUUUU2UUUU
U11111111U
U11111111U
UUUU1UUUUU
UUUU1UUUUU
UUUU1UUUUU
UUUU1UUUUU
UUUU0UUUUU
UUUU0UUUUU
UUUU0UUUUU
