U5U5U5U5U5U5U
BBBBBBBBBBBBB
UBU2U2U2U2UBU
1111111111111
UUUUUUUUUUUUU
11B11B11B11B1
UUUUUUUUUUUUU
5555555555555
UUUUUUUUUUUUU
0000000000000
0000000000000
0000000000000
0000000000000
0000000000000

