UUUUUBBBUUUUUU
UU555BBB555UUU
U55BBBBBBB55UU
U5BB22222BB5UU
UBB2255522BBUU
UB225UUU522BUU
UB25UUUUU52BUU
UBB25UUU52BBUU
UU5BB222BB5UUU
UUU5BBBBB5UUUU
UUUU55B55UUUUU
00000000000000
00000000000000
00000000000000

