11111111
12222221
12UBUBU21
12UBUBU21
12UBUBU21
12222221
11111111
00000000
