B111111111111B
15555555555551
15000000000051
15000000000051
15555555555551
B111111111111B

